{
  "name": "Seabound",
  "width": 18,
  "height": 9,
  "tiles": [
    1, 1, 1, 1, 1, 1, 1, 1, 1, 1, 1, 1, 1, 1, 1, 1, 1, 1,
    0, 0, 0, 0, 0, 0, 0, 0, 1, 0, 0, 0, 0,64, 0, 0, 0, 0,
    0, 1, 1, 1, 0, 1, 1, 0, 1, 0, 1, 0, 1, 0, 1, 1, 1, 0,
    0, 0, 1, 1, 0, 1, 0, 0, 0, 0, 1, 0, 1, 0, 1, 1, 0, 0,
    2, 8, 0, 0, 0, 0, 0, 1, 1, 1, 1, 0, 0, 0, 0, 0,32, 4,
    0, 0, 1, 1, 0, 1, 0, 1, 0, 0, 0, 0, 1, 0, 1, 1, 0, 0,
    0, 1, 1, 1, 0, 1, 0, 1, 0, 1, 0, 1, 1, 0, 1, 1, 1, 0,
    0, 0, 0, 0,16, 0, 0, 0, 0, 1, 0, 0, 0, 0, 0, 0, 0, 0,
    1, 1, 1, 1, 1, 1, 1, 1, 1, 1, 1, 1, 1, 1, 1, 1, 1, 1
  ]
}
